6 6 6 6 6 6 6 6 6 6 6 6 
6 6 6 6 6 6 6 6 6 6 6 6 
6 6 6 1 1 1 6 6 6 6 6 6 
6 6 6 1 3 1 6 6 6 6 6 6 
6 6 6 1 0 1 1 1 1 6 6 6 
6 1 1 1 2 0 2 3 1 6 6 6 
6 1 3 0 2 4 1 1 1 6 6 6 
6 1 1 1 1 2 1 6 6 6 6 6 
6 6 6 6 1 3 1 6 6 6 6 6 
6 6 6 6 1 1 1 6 6 6 6 6 
6 6 6 6 6 6 6 6 6 6 6 6 
6 6 6 6 6 6 6 6 6 6 6 6 
