6 6 6 6 6 6 6 6 6 6 6 6 
6 6 6 6 6 6 6 6 6 6 6 6 
6 1 1 1 1 1 1 1 1 1 1 6 
6 1 1 1 1 0 0 0 0 1 1 6 
6 1 1 3 0 2 1 1 0 1 1 6 
6 1 3 3 2 0 2 0 0 4 1 6 
6 1 3 3 0 2 0 2 0 1 1 6 
6 1 1 1 1 1 1 0 0 1 1 6 
6 1 1 1 1 1 1 1 1 1 1 6 
6 6 6 6 6 6 6 6 6 6 6 6 
6 6 6 6 6 6 6 6 6 6 6 6 
6 6 6 6 6 6 6 6 6 6 6 6 
