6 6 6 6 6 6 6 6 6 6 6 6 
6 6 6 6 6 6 6 6 6 6 6 6 
6 6 1 1 1 1 1 1 1 1 6 6 
6 6 1 1 1 0 0 4 1 1 6 6 
6 6 1 0 0 2 3 0 1 1 6 6 
6 6 1 0 0 3 2 3 0 1 6 6 
6 6 1 1 1 0 1 2 0 1 6 6 
6 6 1 1 1 0 0 0 1 1 6 6 
6 6 1 1 1 1 1 1 1 1 6 6 
6 6 6 6 6 6 6 6 6 6 6 6 
6 6 6 6 6 6 6 6 6 6 6 6 
6 6 6 6 6 6 6 6 6 6 6 6 
