6 6 6 6 6 6 6 6 6 6 6 6 
6 6 6 6 6 6 6 6 6 6 6 6 
6 6 1 1 1 1 1 1 1 1 1 6 
6 6 1 1 1 0 0 1 0 4 1 6 
6 6 1 1 0 0 0 1 0 0 1 6 
6 6 1 1 2 0 2 0 2 0 1 6 
6 6 1 1 0 2 1 1 0 0 1 6 
6 1 1 1 0 2 0 1 0 1 1 6 
6 1 3 3 3 3 3 0 0 1 1 6 	
6 1 1 1 1 1 1 1 1 1 1 6 
6 6 6 6 6 6 6 6 6 6 6 6 
6 6 6 6 6 6 6 6 6 6 6 6 
