6 6 6 6 6 6 6 6 6 6 6 6 
6 6 1 1 1 1 1 1 1 6 6 6 
6 6 1 1 0 0 1 1 1 6 6 6 
6 6 1 1 4 2 0 0 1 6 6 6 
6 6 1 1 1 0 1 0 1 1 6 6 
6 6 1 3 1 0 1 0 0 1 6 6 
6 6 1 3 2 0 0 1 0 1 6 6 
6 6 1 3 0 0 0 2 0 1 6 6 
6 6 1 1 1 1 1 1 1 1 6 6 
6 6 6 6 6 6 6 6 6 6 6 6 
6 6 6 6 6 6 6 6 6 6 6 6 
6 6 6 6 6 6 6 6 6 6 6 6 
