6 6 6 6 6 6 6 6 6 6 6 6 
6 6 1 1 1 1 1 1 1 6 6 6 
6 6 1 0 3 3 2 0 1 6 6 6 
6 6 1 0 1 0 2 0 1 6 6 6 
6 6 1 0 1 0 1 0 1 6 6 6 
6 6 1 2 4 0 1 0 1 6 6 6 
6 6 1 3 2 0 0 0 1 6 6 6 
6 6 1 3 1 1 1 1 1 6 6 6 
6 6 1 1 1 1 6 6 6 6 6 6 
6 6 6 6 6 6 6 6 6 6 6 6 
6 6 6 6 6 6 6 6 6 6 6 6 
6 6 6 6 6 6 6 6 6 6 6 6 
