6 6 6 6 6 6 6 6 6 6 6 6 
6 6 6 6 6 6 6 6 6 6 6 6 
6 6 1 1 1 1 1 1 1 1 6 6 
6 6 1 0 0 1 0 0 0 1 6 6 
6 6 1 0 2 3 3 2 0 1 6 6 
6 6 1 4 2 3 0 0 1 1 6 6 
6 6 1 0 2 3 3 2 0 1 6 6 
6 6 1 0 0 1 0 0 0 1 6 6 
6 6 1 1 1 1 1 1 1 1 6 6 
6 6 6 6 6 6 6 6 6 6 6 6 
6 6 6 6 6 6 6 6 6 6 6 6 
6 6 6 6 6 6 6 6 6 6 6 6 
